11111111111111111111111111111111
1      2                2      1
1      2       22       2      1
1      2      2222      2      1
1222           22           2221
1                              1
1       11            11       1
1111   1111    22    1111   1111
1       11    2222    11       1
1            221122            1
1           22111122           1
122222     2211111122     222221
122222     2211111122     222221
1           22111122           1
1            221122            1
1       11    2222    11       1
1111   1111    22    1111   1111
1       11            11       1
1                              1
1222           22           2221
1      2      2222      2      1
1      2       22       2      1
1      2                2      1
11111111111111111111111111111111